026 016
02 01 02 01 02 01 02 01 02 01 02 01 02 01 02 01 02 01 02 01 02 01 02 01 02 01
01 01 02 02 02 02 02 02 02 02 02 02 02 02 02 02 02 02 02 02 02 02 02 02 03 02
02 12 56 02 02 02 02 02 56 56 56 56 56 56 56 56 56 56 56 56 56 56 56 56 14 01
01 12 56 09 09 09 09 09 56 56 56 56 56 56 56 56 56 56 56 56 56 56 56 56 14 02
02 12 56 09 09 09 09 09 56 56 56 56 01 56 56 56 56 56 56 56 56 56 56 56 14 01
01 12 56 16 16 16 16 16 56 56 56 56 05 56 56 56 56 56 56 56 56 56 56 56 14 02
02 12 56 19 19 19 19 19 56 56 56 56 05 56 56 56 56 56 56 56 56 56 56 56 14 01
01 12 56 19 19 19 19 19 15 15 15 15 12 56 56 56 56 56 56 56 56 56 56 56 14 02
02 12 56 30 30 30 30 30 56 56 56 56 56 56 56 56 56 56 56 56 56 56 56 56 14 01
01 12 56 56 56 56 56 56 56 56 56 56 56 56 56 56 56 56 56 56 56 56 56 56 14 02
02 12 56 56 56 56 56 56 56 56 56 56 56 56 56 56 56 56 56 17 24 24 24 18 14 01
01 12 56 56 56 56 56 56 56 56 56 56 56 56 56 56 56 56 56 14 56 02 56 12 14 02
02 12 56 56 56 56 56 56 56 56 56 56 56 56 56 56 56 17 24 25 02 56 02 12 14 01
01 12 56 56 56 56 56 56 56 56 56 56 56 56 56 56 56 14 01 02 01 02 01 12 14 02
02 23 24 24 24 24 24 24 24 24 24 24 24 24 24 24 24 25 02 01 02 01 02 23 25 01
01 02 01 02 01 02 01 02 01 02 01 02 01 02 01 02 01 02 01 02 01 02 01 02 01 02
w w w w w w w w w w w w w w w w w w w w w w w w w w
w g g g g g g g g g g g g g g g g g g g g g g g g w
w g g wr wr wr wr wr g g g g g g g g g g g g g g g g g w
w g g wr wr wr wr wr g g g g g g g g g g g g g g g g g w
w g g wr wr wr wr wr g g g g f g g g g g g g g g g g g w
w g g wr wr wr wr wr g g g g f g g g g g g g g g g g g w
w g g wr wr wr wr wr g g g g f g g g g g g g g g g g g w
w g g wr wr wr wr wr f f f f f g g g g g g g g g g g g w
w g g wr wr wr wr wr g g g g g g g g g g g g g g g g g w
w g g g g g g g g g g g g g g g g g g g g g g g g w
w g g g g g g g g g g g g g g g g g g g g g g g g w
w g g g g g g g g g g g g g g g g g g g w w w g g w
w g g g g g g g g g g g g g g g g g g g w w w g g w
w g g g g g g g g g g g g g g g g g w w w w w g g w
w g g g g g g g g g g g g g g g g g w w w w w g g w
w w w w w w w w w w w w w w w w w w w w w w w w w w